阿=a
艾=ai
柏=bai
淳=chun
侧=ce
车=che
思=si
丁=ding
大=da
冯=feng
曾=zeng
盖=ge
和=he
贾=jia
景=jing
乐=le
六=liu
泷=shuang
莫=mo
宁=ning
那=na
娜=na
彭=peng
朴=piao
卜=bo
奇=qi
覃=qin
瞿=qu
孙=sun
单=shan
沈=shen
隋=sui
石=shi
盛=sheng
汤=tang
万=wan
许=xu
信=xin
解=xie
俞=yu
叶=ye
殷=yin
朱=zhu
泽=ze
翟=zhai
查=zha
臧=zang
扎=zha
薄=bo
仇=qiu
谌=chen
朝=chao
都=du
广=guang
句=gou
见=jian
隗=kui
卡=ka
郦=li
牟=mou
缪=miu
南=nan
区=ou
强=qiang
若=ruo
杉=shan
塞=sai
尉=yu
仰=yang
种=zhong
褚=chu
澄=cheng
称=cheng
乾=qian
眭=sui